út	ú
GóG tornáS	GóG torná
vál ogat ott	váloogat ott
keres ő	keresőő
modul interféS é t	modul interféSéé t
omnihttpd	omn httpd
feldolgozó ként	fel olg zó ként
itt	i t
tö bb et	többb et
php_gtk	php_g k
i _ iii _	i _ ii  _
tö bb	többb
3m_re	3m_ e
fáni	fá
fa házikó t	fahházikó t
közben	köz en
lakó	lak
fa gerendá s	faggerend ss
aztán	aztá
állítólag	állít lag
tár sas ág tól	társsas ág tól
múlva	múl a
őS é n	őSéé n
váll alt _	vállaalt _
tár sas ág	társsas ág
perczel	perc el
igaz a	igazaa
Sóval	Só al
igazából	igaz ból
naGban	naG an
tég ed	tégeed
rá Codálkoz ás	ráCCodálkoz ás
inspirál	ins irál
apá m mal	apámm mal
röhej es	röhejees
harsoná d at	harsonádd at
alkot ó	alkotóó
kis Gerek	kis Ger k
elsősorban	el ősorban
igazán	igaz
mag a	magaa
én em	éneem
érez het ném	érezhhet ném
Sörf öz ök	Sör ööz ök
boldog gá	boldogááá
dönt ő	döntőő
fi a	fiaa
keGesrend i	keG srend i
SobráS	Sobr S
forma tervező k	forma terv ző k
péter _ németh	péter__ német
verseNz ő pár os a	verseNzőő pár os a
jobban	jo ban
jég kocka	jégkkocka
fog mos ás hoz	fogmmos ás hoz
vi Gen	viGGen
fő köNv i	fő köN  i
mat_	mat
malom verseN	malo  verseN
Cütörtök	Cütör  k
lehangoltság ot	le angoltságoot
Zeb kendő re	Zeb kend  re
húG Cő Gulladás	húG Cő Gullad s
fürd ő víz be	fürd ő v z be
megSűntetésében	meg űntetés ben
máj tiStít ás	májttiStít ás
eNhít i	eN ít i
bálváN imád ó	bál áN i ád ó
eGiptom	eG pt m
emlékez zetek	emlékezzzet k
chanukakor	chanuka  r
kiváltság ok at	ki áltság ok at
anGal a	anGalaa
üSök	üS k
hivatás á t	hivat s á t
iriG ség	iriGsség
tündököl	tünd k l
örök	ör k
iriG ség é vel	iriGsség é vel
hit e	hitee
babiloniai	babilonia
Seret etlen ség	Sereteetlen ség
leg első	legeelső
jel véN e	jelvvéN e
Cöpp Ni	CöppNNi
Sáz ad os	Sázaad os
többNire	többNi e
Gerek lelk ű	Gerekllelk ű
fenti	fent
Sélső ség es	Sélsősség es
le ár az ás ok	le áraaz ás ok
Gerek kor od ra	Gerek korood ra
alap listá n	alapllistá n
benn etek	benneetek
társ atok	társaatok
igazgató	igazgat
hárm an	hármaan
ké ne	kénne
mindhárm an	mindhármaan
elé jük	eléjjük
le dob ja	leddob ja
felett i	fel tt i
történ ő	törté  ő
segít ő	segítőő
assisi	as isi
gondolkodó	gondolkod
leg tö bb Sör	leg tö bbSSör
sár rét en	sárrrét en
máshoG	más oG
partizán t	partizá tt
uGanez	uGan z
küzd ő k	küzdőő k
Gűlöl tem	Gűlölttem
meNNire	meNNi e
való s ít ottam	valóss ít ottam
ki zökken ek	ki z kken ek
jólnevelt	jól evel
tiStá bb an	tiStábbb an
montreal	montre l
semmiLen	semmiL n
köNNű	köNN
átmérőjű	átmérő ű
súL a	súLaa
1 _ 3 _a	1 _ 3 _
Gár tó	Gárttó
jelent ő s en	jelentőő s en
hasonl ó k	hasonlóó k
nemtommi	nem ommi
konkrét	konk ét
el ismer és e képpen	el ismer és ekképpen
díS polgár a	díS polgá  a
hét ről _ hét re	hétrről _ hét re
kap ott	kapoott
el haláss zák	el haláS  áák
téNked és e	téN ed és e
oLkor	oL or
bírság	bír ág
Cök ken és ről	Cökkken és ről
dolg a	dolgaa
vízirendőr ség	víz rendőr ség
direktívá ban	direktívábban
leg keves ebb	leg kev s ebb
eu _beli	eu__ eli
1 _ én	1 _ é
változ atlan ul	változaatlan ul
bél sejt ek en	bélssejt ek en
spektrofotometriá s	spektro otometriáss
tekintve	tekint e
króm meNN i ség	króm meNNii ség
Cökken	Cökk n
ön SabáLoz ó	ön SabáL z ó
só oldat tal	sóooldat tal
sav val	savaval
5 _ 5_ re	5 _ 5  re
ftálsav	ftál av
SeNN viz et	SeNN vizeet
ultrafit	ultrafi
people	peop e
mellék termék e ként	mellék termék ekként
építéS mérnök i	ép téS mérnök i
mégisCak	mégis  k
ital fedezet é re	italffedezet é re
Gomr a	Gomraa
napsütötte	nap üt tte
nehez ed ő	nehezeed ő
meg élénkül	megéélé   l
divat os	divatoos
alkalmazkod ás i	alkalm zkod ás i
oss zad	oSS add
SakaS onként	Saka  onként
10 _ Ser	10__ Ser
eDett ség i	eD ttsség i
el ér ed	el éreed
tele pakol juk	teleppakol juk
futball meCC re	fut allmmeCC re
önkormáNzat i	önkormáNzatii
tiSt es ség telen	tiStees ség telen
5 _ 1_ re	5 _ 1  re
juh ár	juháár
tudniillik	tud iill k
legmeSSebbmenőkig	leg eSSebbeenőkig
hoSS iráN ban	hoSSiiráN ban
élet műv e	élet mű  e
parlament i	parlamentii
párt	pár
bel üG miniSter e	belüüG miniSter e
frakció vezető je	frakiió vezető je
kép viselő	kép visel
jelöl tes sem	jelölttes sem
e tet hető k	ettet hető k
másnap tól	más ap tól
változtat	változ at
trianon	trian n
Semét domb já ról	Semétddomb já ról
ül ő	ülőő
mSmp _ tag ok	mSmp__ tag ok
tele Zúfol t	teleZZú ol t
Sen t _ iváNi k ra	Sentt _ iváN  k ra
jöv ő	jövőő
hazutolják	hazutol ák
fehérje érték e	fehérjeéérték e
fehérje tartalm a	fehérjettartalm a
Sak miniSter	SakmminiSter
él es ebb en	élees ebb en
hardy t	hardytt
NomdakéSS é	Nomda éSSéé
lel t	leltt
táp pénz	tápppénz
átk oz va	át  oz va
wellness	well ess
jól es ő	jólees ő
friss en	fris  en
gerinc trén ing	gerinc trén i g
Gömbér	Göm ér
igaz ít otta	igazíít otta
igéNl ő k nek	igéNlőő k nek
felhaSnáló	fel aSnál
jelöl t	jelöltt
fel ad andó	fel adaandó
2 000_ ben	2 0 0_ ben
kabát	kabá
margit	margi
Solgál tat ó	Solgálttat ó
ismertet em	ismer et em
naGfokú	naG ok
öl ő sejt ek	ölőő s j  ek
díCéretesek	díC ret sek
elektro dinamika	elektroddinamika
kilo méter re	ki o méter re
apá m at	apámm at
meg köNNebbül és	meg köNN bbül és
előz ő nél	előzőő nél
Luk am ba	Lukaam ba
őrjít ő	őr  t ő
fárad t ak	fárad taak
fek het tem	fekhhet tem
sötét ed ni	sötéteed ni
fiatal ít ottam	fiatalíít ottam
betörő t	be örő t
tryba	try a
Ser elem	Sereelem
meg kérd ő jel ez ve	meg kérdőő jel ez ve
be tekint eni	bettekint eni
elhivatott ság á nak	elhivatottsság á nak
reflektor féN be	reflektorfféN be
pipi k	pipikk
író	ír
Sentel t e	Sentel tee
diósGőr i	diós  rii
Cempé z ik	Cempézz ik
társ keres ő	társ keresőő
eGmás é	eGm séé
dolg oz tat niuk	dolgooz tat niuk
rugalmas ság á t	rugalm s ság á t
valóraváltásának	valóraváltás nak
következméN e képpen	következméN ekképpen
utol ér het i	utoléér het i
körül tekint ő nek	körül tekintőő nek
rá haGatkoz ni	rá haGat oz ni
Semlélő	Semlél
amiért	ami rt
mag am é vá	magaam é vá
lelkivezetővel	lelkiv zető el
leg drágá bb	leg drág  bb
mindenható	minden ató
tiSt áz ás	tiStááz ás
alapS ik	alap  ik
kéSetetéseket	kéSetet seket
Sindróma	Sindró a
Sélső ség ei	Sélsősség ei
józan abb ul	józanaabb ul
pártatlan	párt tlan
függő en _	függ  en _
1 00 __ os	100  __ os
teljesítméN	teljes tméN
ellent mond	ellentmmond
kijárat á nál	ki árat á nál
valósul hat	való ul hat
koS os	koSoos
ír unk	ír u k
jövet	jöv t
fogan t ként	foganttkként
érték ítélet é re	érték ít let é re
ér etlen	éreetlen
alul finanSíroz ott	alul finanSír zoott
magános ít ás i	magán s ít ás i
jobb oldal	jobbooldal
medGessy _ kormáN	medGes y__ kormáN
mondvaCinált	mond aCinál
felipe	fel pe
napilap ban	nap lap ban
pontével	pont vel
boroGin nak	bor Gin nak
fél lel	félllel
fenn áll t	fennááll t
leg drágá bb ak nak	leg drág bbb ak nak
Gár foglaló k	Gárffoglaló k
had a	hadaa
haj ó z ás t	hajóó z ás t
öntöz ni	önt z ni
ötSörös é re	öt ör séé re
damaSkuS	dama  uS
Sáz ezr ek	Sáz ez  ek
mindörökre	mindör k e
cérna keSTű ben	cér a keSTű een
harm ad Sor	harmaad Sor
él es ek	élees ek
bor t	bortt
meNNi ért	meNN  ért
trófeá val	trffeá val
tű z ő	tűzzőő
end _ el	end__ el
tündérké k	tündér é k
tánc parkett en	tánc parket  en
panC á nak	panCáá nak
be Göker ez nek	be Gök r ez nek
ab ba	abbba
érez zék	ér z zék
mércé t	mérc  t
fel ve tet tünk	fel vettetttünk
hangSóró k	hang óró k
le sugároz ni	le sugár z ni
mindennap ok ban	minden ap ok ban
tér le kép ez és	térllekkép ez és
hang sugárz ó	hang sugárzóó
sugárz ó	sugárzóó
mostanra	mostan a
mobil Solgáltató k	mobil Solgál ató k
él ő ben	élőő ben
ír d	írdd
jel öl és sel	jelööl és sel
halmaz ba	halm z ba
vol t á t	volttáá t
kép erNő re	képeerNő re
doki	dok
olajbamártott	olaj amártott
acél háló n	acélhháló n
expreSS ion izmus	expreSSiioniizmus
ép ül ő	épüül ő
üt	ü
árad	ár d
1 9 50_ től	1 9 50  től
többkötetet	több ötet t
biZerg et ő	biZergeetőő
tamás t	tam s t
repertoár juk at	repertoárjjuk at
át rándul	átrrándul
hangol gat tak	hangolggat tak
tót	tó
elvégre	el égre
erdő fel újít ás	erdő felúúj t ás
örvendetes	örvendet s
Sakértő nk	Sak rtő nk
élet eséL ek	élet es L ek
ritká bb	ritkábbb
eGik é be	eG k é be
áGás ok ban	áG s ok ban
fecókára	fecóká a
dolgoz om	dolg z om
buS közleked és	buSkközleked és
hű ség bónuS ként	hűsség bónuS ként
union _ casco	union__ casco
irodá nk hoz _	irodánnk hoz _
ön rakod ó s	önrrakod ó s
vev ő Solgálat i	vevőő Solgálat i
építkez és e	ép tkez és e
mindenkori	mindenkor
város Serte	vároS Ser e
közleked ő k	közlekedőő k
köNves	köNv s
heLezked ik	heL zked ik
nép liget i	néplliget i
fő lépCő n	fő lép ő n
jel lemez	jelllem z
pénzjeG ki ad ó	pénz eG ki adóó
köNv Sakértő i	köNv Sak rtő i
végzettség ű	végzett ég ű
elő kéSítő i	elő kéS t  i
után am	utánaam
hal áS háló t	halááS háló t
budi ból _	budibból _
illat _	ill t _
naranC Sín ű	narancSSss nű
bolhá k _	bolhákk _
felett _	fel tt _
Cen t em _	Centteem _
méLkék	méL ék
burkolóD ott _	burkoló  ott _
alS anak _	alSaanak _
lemez ünk	le  z ünk
kobak	kob k
fel tűn és ről	felttűn és ről
fonó ban	fon bban
Só Só ló féle	Só Só lóffél
fazon t	fazontt
kispál	kis ál
líra i bb	lír ii bb
meg hallgat ta	meg hallgat aa
félre dob ta	félreddobtta
felhő k	fel ő k
spontaneitás a	spontan itás a
el vi ttek	el vitttek
utca zenéS nek	utcazzenéS nek
kiadó nál	ki dó nál
mindöSSesen	mindöSSes n
Sakma Coport os	Sak a Coport os
ember GóGáSat i	emberGGóGáSat i
tönkre te tte	tönkrettettte
utópista	utó ista
év járat ú	év jár t ú
említ ett ek	említ etteek
leg eG én i bb	leg eGéén i bb
hang vétel	hangvvétel
kiküldetés kor	ki üldet skkor
zelk	zel
meNegző	meNegz
pihanő	piha
ön meg mér et és i	önmmegmméreet és i
alap elv e	alap el  e
elán nal	el n nal
higgadság	higgad ág
meg boCájt ani	meg boCáj  ani
porc elán bolt ban	porceelán bolt ban
sportSerűtlen	sport erűtlen
miheLt	miheL
végre hajt ó	végrehhajtóó
Só Céplés ek nek	Só Cép  seek nek
Cök ken és	Cökkken és
norvégiá ból	norvégi  ból
svájc ból	svájcóból
be vállal ó s ak	be vállalóó s ak
balassaGarmat i ak	balassaGarmatii ak
balassaGarmat	balas aGarmat
trükk öt	trük  öt
réS eCke	réSeeCke
lehetséges nek	le etség snnek
antropo morf	antropommorf
kunSt	kunS
bor felSín	borffelS n
sors társ aink	sorsttárs aink
köz gazdáS	köz gazdá
méLrepülés é vel	méLrepül s é vel
társadalom tudomáN i	társadalom tudomáNii
el heLezked és	el heL zked és
rejtőzköd ik	rejt zköd ik
evá z ó k tól	evázz ó k tól
érint ett ek	érint etteek
köz gazdáS aink	közggazdáS ai k
2 000 _ s	20000__ s
mozi	moz
ki alakul atlan	ki alakulaatlan
Sám i t	Sámii t
akar atlan ul	akaraatlan ul
egéS e	egéSee
el eNéS ő	eleeNéS ő
balatontourist	balatontouris
körNék beli	körNékbbeli
mosonmaGaróvár	moson aGaróvár
fürd ő fejleSt és re	fürdőő fejleSt és re
kérdezget lek	kérdez etllek
hátha	hát a
ő rá	ő áá
velejáró ja ként	vel járó ja ként
éSak abb ra	éSa  abb ra
vad idegen	vadiidegen
trikolór nak	trikolórnnak
SivárváN záSló	Sivár áNzzáSló
leg hű ség es ebb	leg hűsség es ebb
fő cím zené jé t	főccímzz né jé t
Sám á ban _	Sám ábban _
doktorátus ok at	doktor tus ok at
üdvözöl lek	üdvöz l lek
érez d	ér zdd
kisalföld	kis lföld
un od	unood
Capdá s	Capd  s
Zűri	Zűr
ál ló víz é t	állló víz é t
Gőztes t	Gőztestt
föl kerül nek	fölkkerül nek
instrument	instrum nt
korSerű nek	kor erű nek
állat orvos hoz	állatoorvos hoz
közép _ áZiá ból	közép _ á iá ból
jeromos nál	jerom s nál
Sótfogad	Sót ogad
vörösl ő	vöröslőő
naG obb ról	naGoobb ról
pumi	pum
emlékez em _	emlékezeem _
sír ván	sírvván
vértes	vért s
Sőlő nem es ít ő	Sől  nem es ít ő
naG követ	naG köv t
haGomáN teremt ő	haGomáN teremtőő
keStheL re	keSt eL re
SakSofontáncok	Sak ofont nc k
font	fon
baki	bak
utánvét tel	utánvétttel
cd _ rom hoz	cd__ rom hoz
Sén báNáSat	Sén báNáS t
fog alm i	fogaalm i
fej ez őd tek	fejeez őd tek
heL i ség ek et	heL isség ek et
le sétál va	le sét l va
drágá bb	drágábbb
turista ház	turistahház
heG oldal ak	heG olda  ak
Cók kal	Cókkkal
te dd	teddd
ur am	uraam
ajtó Cattan ás	ajtó Cat  n ás
öSSe rándul	öSSerrándul
Cörg ő kíGó k kal	Cörgőő kíGó k kal
faj aik	fa  aik
meg valósul jon	meg való ul jon
tetris_típusú	tetris típusú
alak ú	alakúú
rc_k	rc
SeméL gép koCi k hoz	SeméLggép koCikk hoz
fut ó mű	futóó mű
áram vonal as	ára  vonal as
éppenséggel	éppenség  l
ép ít és mód	épíít és mód
hat fokozat ú	hatffokozat ú
ki ok os ít ottak	ki ok os ít ott k
kaGló s ít ott	kaGl  s ít ott
terror izmus nak	terroriizmus nak
fog alm á t	fogaalm á t
terror Servezet	terror Serv zet
abv_	abv
elemz ő munka	elemzőő m nka
hadihajó k	hadi ajó k
washington i	washingtonii
Servezet Serű	Servezet Ser
járőr öz és t	jár r öz és t
vál ság tér ség ben	válsság tér ség ben
marco _ záSló alj	marco _ záSló al
be vet és re	be ve  és re
meg semmi s ít és e	meg semmiss ít és e
ezred	ezr d
Specnaz_erővel	Specnaz_erő el
fej hallgató	fej hallgat
előN e	előNee
rajz a	rajzaa
vám paranCnok	vám par nCnok
tranzit rend Ser	tranzitrrend Ser
7 000_ re	700 0_ re
darab ok	dar b ok
aG am ból	aGaam ból
fel tüntet ve	felttüntet ve
túlöltözött ség	túlöltöz ttsség
naGvárad i	naG árad i
feNves erdő n	feNv seerdő n
ártánd	árt nd
teljasíti	teljasít
Nelv ed re	Nelveed re
hús Selet ek et	húS Selet ek et
fok haGmá val	fok haGm  val
Sentgotthárd on	Sent otthárdoon
zala i	zal ii
udvar i as ság ból	udvarii as ság ból
karéj á t	karé áá t
eközben	eköz en
házaspár	házas ár
kiCi t _ naG ot	ki itt__ naG ot
meg mozg at ó	meg mozgaat ó
háromSáz	három áz
kett en _ hárm an	ketteen _ hármaan
érez te	ér z te
törZ e	törZee
sugár oz hat nak	sugárooz hat nak
n_ edik	n eed k
be men ő	bemme  ő
iráN a	iráNaa
kuTaxkoordináta	kuTax oordináta
éste	és
zöldbab	zöld ab
mulatság os ak	mulat ág os ak
agg ód j	aggóód j
idő d	idődd
élet ritmus uk ból	életrritmus uk ból
SabáLSerű	SabáL erű
elm_	elm
kirendeltség ei n	ki endeltség ei n
abSorbeál ja	abSor eál ja
darab ban	dar bbban
fordítva	fordít a
diSSertáció ba	diSSer áció ba
társadalom etika i	társadalomeetika i
ámul janak	ámuljjanak
köSönt	köSön
iLvó	iLv
utcá i n	utcá inn
köz épület	közéépület
város alapító	város alapít
közelmúlt beli	közelmúltbbeli
máTás ra	máTá  ra
siker _ Stori t	siker _ Stor  t
1 00 __ ban	100 ___ ban
az előtt	azeelő t
naGréSt	naGréS
tő kés társ tól	tőkkésttárs tól
ki haSnál atlan ul	ki haSnálaatlan ul
foglalkoztat nának	foglalkoz at nán k
innovátorokat	innovátor kat
köNNűipar i	köNN  parii
befektető k	be ek ető k
páLá z tak	páLázz tak
falc on	fal  on
tud ás Sint	tudááS Sint
eGbe vág	eG e vág
ex port nak	ex por  nak
Gakori bb á	Gakor bbb á
xxx viii _	xx  viii _
befoLásol ás uk ra	be oLásol ás uk ra
vég ig	végiig
zökken ő mentes	zökkenőő ment s
átmenet	át enet
rend ez ő _ elv ek	rendeez ő _ el  ek
réSletezettségű	réSlet zettség
ebö	eb
1 8 _ _ ától	1 8 ___ á  l
határozat ai ban	határ zat ai ban
finanSíroz ó	finanSírozóó
eGbe vág nak	eG e vág nak
pót költség vetés	pót költség vet s
három Sor os á ra	három Soroos á ra
juta lom mal	jutallom mal
ellen súL oz ás ár a	ellen súL oz ás á aa
3 1 _ én	3 1 _één
bírság _ hátralék ot	bír ág _ hátralék ot
bek _	be  _
3 0 _ 5 __ os	300 _ 5 __ os
1 5 __ é ig	1 5 __ éiig
1__jei	1 _jei
kód karban tart ás	kódkkar an tart ás
meGé nként	meGénn  nt
xxx iv _	xx  i  _
cél előiráNzat	céleelő ráNzat
viSSavétel é hez	viSSa étel é hez
6 8 __ os	6 8___ os
5 5 __ a	5 5___ a
5 9 _ 4 __ uk	5 9 _ 4 _  uk
túl lép és	túlllép és
vaGon elem et	vaGon el m et
ok irat tal	okiirat tal
eG SeméL i	eGSSe éL i
ön áll ó ság á nak	ön ál  ó ság á nak
keret gazdálkod ás i	keretggazdálkod ás i
keret gazdálkod ás	keretggazdálkod ás
távol lev ő k	távolllevőő k
viSSamenőleg es	viSSa  nőlegees
kirendeltség	kirendelt ég
net_nek	net_ ek
rég ebbi	régeebb
fog orvos i	fogoorv s i
véN ellenőrz és i	véN ellen rz és i
probléma mentes	problémammentes
ráCC al	ráCCaal
_ fe	_ffe
el tol ód nak	el tolóód nak
iráN unk ban _ ami	iráN unk ban _ am
páLá z zon	páLázz zon
mentor nak	mentornnak
vállakoznának	vállak z á ak
pedagógus hiáN	pedagógushhiáN
miatt a	miattaa
veStes ek	veSt s ek
T_k	T_
Sak segítség et	Sak segít ég et
ágnes	ág es
veSéLeztet jük	veSéL ztet jük
leg kezd ett ebb	leg kezdeett ebb
Gomor görC	GomorggörC
öSSe függ	öSSeffügg
hoppá	hop á
külön áll ó	különááll ó
átalakítóknal	át lakító  al
alapul ó k	alapulóó k
tartalm ak ért	tartalm a  ért
pénz üG őr ség	pénz üG őrsség
hal álhír é t	haláál ír é t
hangz anak	hangzaanak
kriStián nak	kriStiá  nak
burgoNa bog ár	burgoNabbogáár
levél tetű	levélttet
kár tevő	kár tev
növéN véd ő	növéN védőő
cukor répá ban	cukor rép bban
be teleped ő ben	betteleped ő ben
út Sél ek en	útSSéleek en
öSSeíró k	öSSe ró k
ma i nál	maii nál
be tör t	bettör t
páciens ei	páciensiei
pálcá t	pálc  t
fülemüle	fül müle
le vezet és é re	levvezet és é re
köNv viZgáló	köNv viZgál
judik	jud k
el tel t e	el tel tee
egéSnapon	egéS apon
mű véS palántá k	művvéS palántá k
bérbeadó ja	bérbe dó ja
jog ellenes en	jog ellen s en
ft _ m	ft__ m
polgármeteri	polgár eter
meCekvidéki	meCekvidék
raktár unk on	raktá  unk on
leg rég ebbi	leg rég ebb
úss zuk	úS  zuk
babusgat ás a	babu  atáás a
jólneveltség	jól evelt ég
herborni	herbor i
pánSófiájának	pánS  iá   ak
öncélú	öncél
drábik	drábi
teremtméN	teremt éN
fej lett ség re	fejllett ség re
tév ut ak on	tévuut ak on
dolg aink	dolg ai k
el len ség es ked és	elllen ség es ked és
ve hes se	vehhes se
vad állat	vadáállat
didaktika i	didak ika i
tekintéLelvű ség	tekintéL lvű ség
Sármaz ik _	Sármaziik _
mértékletes ség re	mértéklet s ség re
ki irt anád	ki irtaanád
hi dd	hiddd
kor uk ig	koruuk ig
alakít	al kít
lépCőzet es	lép őzet es
babusgat ás á t	babu  atáás á t
édes aNa _ Germek	édes aNa _ Gere k
meg gereben ez ik	meg ger beneez ik
eb beli	eb bel
hétSáz	hét áz
elöljáró i	el ljáró i
el maraStal ó	el maraSt l ó
ur a	uraa
boLong ó	boLongóó
oratoire	oratoi e
Sentlélek	Sent él k
iskolá s ai	iskol ss ai
eG felől	eGffel l
Germek i es	Germekii es
férfi ként	férfi k nt
barcaság on	barca  g on
kolléGiomban	kolléGiom an
1 6 0 6_ tól	1 600 6_ tól
iktári	iktár
nassau i	nassauii
hatSáz	hat áz
tanít ó ra	tanítóó ra
anglikán	angliká
haza tér ő	hazattér ő
puritánusok	puritánus k
polgár láN t	polgárlláN t
basiriust	basirius
disputá ra	disputárra
eGbe mos ta	eGbe mostta
fog alm ai t	fogaalm ai t
sor rend jé vel	sorrrend jé vel
görög ül	görögüül
ki tág ít otta	ki tágíít otta
köv ön	kövöön
váG ódá s t	váG ód ss t
falv ak ban	fal  ak ban
nélkülöz i	nélkül z i
híján	híj n
hatvan ezer	hat an ezer
böCületes	böCület s
nép i es	népii es
eGed uralm á t	eGeduuralm á t
leg ki vál ó bb	leg kivválóó bb
oSt ogat ta	oStoogat ta
syllabicáltatni	syllabicál  tni
eGház ba	eG áz ba
ellen tét té	ellenttét té
le lepl ez és e	lellepl ez és e
kálvin i	kálv n i
siettet te	siet  ttte
fek tet ett	fekttet ett
kelt	kel
eDett ség é nek	eD ttsség é nek
Süle ik nek	Sül  ik nek
érzék Serv i	érzék Ser  i
reflexió	refl xió
kétes	két s
úriember é nél	úr ember é nél
német ül	németüül
réglement	réglem nt
verne	ver e
ürközpont	ürköz ont
sepsiSentGörG ön	sepsiSentGörGöön
vár templom	vár templ m
mikó _ kastéL	mikó__ kastéL
fa medencé t	fammedencé t
kováSna_komandói	kováSna komandói
komandóra	komandó a
gelencén	gelen é
világáború	világ ború
háromSék ről	három ék ről
feled hetetlen	feled het tlen
import őr ei	importőő  ei
igaz od janak	igazood janak
18_a	1 _a
tróCáNi	tróCáN
9 5 __ a	955 __ a
Sab ás ú	Sabáás ú
kérvéN t	kér éN t
földmíves ek ből	föld ív seek ből
Se bb re	Sebbb re
köz hivatal i	közhhivatal i
ön értelmez és	ön értelm z és
Serep oSt ás	Sere  oSt ás
lego_varáZlatrendSer	grregg rvraaraeneeen
kondmeG	kond eG
a_z_	a z
tiSántúl i	tiSántúlii
bereTTóújfalu i	bereTTóújfaluii
part bérlet ek kel	partbbérlet ek kel
program iroda	programii oda
Sár Nal ás á nak	SárNNal ás á nak
Ser ez tél	Sereez tél
al só hát i	alssó hát i
feled d	feleddd
üGvéd jelölt ek	üGvéd jelöl  ek
mind _ mind	mind__ mind
Sak dolgozat om	Sak dolg zat om
strabag_nál	strabag_ ál
bűn tett ük	bűn tet üük
cc _ pat	cc__ pat
bureauk	bure uk
mód Ser tan	mód Ser t n
tájékoztat ja	tájék ztat ja
naG díj	naGddíj
fel tétel ez nek	felttétel ez nek
cukráS	cukr S
bán ás mód	bánáás mód
mester jelölt ek	mester jelöl  ek
konfliktus kezel ő	konfliktus kezelőő
séma	sém
meg világít ottuk	meg világ t ottuk
serkentőleg	serkent leg
finom od tak	finomoodttak
ön képz és	önkképz és
bróker botráN	brókerobotráN
eGüttműködére	eGütt űköd re
ér tem	érttem
névnélküli	név élküli
követendö	követ ndö
roSSmájú ság om at	roSS ájú ság om at
12_az	1 _az
hozzáSolásodat	hozzá ol s d t
én Serint em	én Ser nt em
fel jog os ít va	fel jogoos ít va
kér etlen ül	kéreetlen ül
kamerá ba	kamer bba
iskolá s ok nak	iskol ss ok nak
posta ládá k	postalládá k
kormáN kiadváN ok	kormáN ki dváN ok
betéve	be   e
külön ít ett	különíít ett
betlent	betlen
le ver te	levver te
büEé jé vel	bü é jé vel
nap unk at	napuunk at
döbbenet es	döbbe et es
cinkota	cink ta
fel öl	felööl
méLrepülés e	méL epül s e
forg ó lézer	forgóóllézer
fel vetít és é t	fel vet t és é t
hatvan adik	hat an ad k
Suverén	Suve  n
be következ t é t	be következ téé t
kár eNhít és i	káreeNhít és i
következméN ek ért	következméN e  ért
okozat i	ok zat i
bizoNít ott á	bizoNít ottáá
GóG áru	GóGááru
légitársaság ot	lég tár aság ot
ki von ta	ki vontta
fog beteg ség	fogbbeteg ség
Solenoid ra	Solen id ra
ellen áll ás	ellenááll ás
civilSférából	civil férából
Gula i	Gulaii
terméSet védő	terméSet véd
al köNv tár ak	alkköNv tár ak
felül ír ja	felülíír ja
fel tör ték	fel törtték
Sámtalan Sor	Sám alan Sor
cél orSág	céloorSág
1 00 _ 1 50_ nel	100 __ 105  nnel
huSast	huSas
körbe meG	kör e meG
életbevágó an	élet evágó an
per es ked és ek re	pereeskked és ek re
leg öreg ebb ek	le  öreg ebb ek
le vezet ve	levvezet ve
ló láb	lólláb
ordítoz ás ig	ordít z ás ig
haza men vén	haza menvvén
vakvezető k höz	vakv zet  k höz
tárGal ó kép es	tárGalóó kép es
tiStára	tiStá
bumfordi	bum ordi
tévé Catorná k	tévéCCatorná k
tétová n	tétovánn
féNN el	féNNeel
dalmata _ dömping	dalma   _ dömping
Sán húz ó	Sánhhúz ó
meg növeked ett	meg növ ked ett
Calád apa	Caládaapa
cipő nk ben	cipőnnk ben
üt ötte	üt öt
mer tünk	merttünk
fel pattan t	fel patt n t
belgrád i	belgrádii
6 _á n	6__ánn
ljubljaná ban	ljubljanábban
póló z nak	pólózz nak
kijev ben	ki ev ben
anti globalizáció s	antigglobalizáció s
hajdú _ bihar	hajdú__ bihar
elhivatott ság ot	elhiva ottsság ot
ön rendelkez ő	önrrendelkez ő
múlt unk	múl  unk
demonaz	demon z
jegesmedvé k et	jegesmedvékk et
mars i	marsii
horgh_nak	horgh_ ak
tulajdonjai	tulajdon  i
eco_	eco
pb _ gáz	pb__ gáz
ki néz ni	kinnéz ni
löv ik	löviik
fel ölel ni	felöölel ni
trén ing	tréniing
el végz ő	elvvégz ő
tud ás át ad ás	tud ás át adáás
kéSülő k	kéS lő k
közeljövő	közel övő
5 _ 6 _á n	5 _ 6__á n
craft	cra t
fel kéSt ette	fel kéS  ette
rá világít ottak	rá világ t ottak
kül föld i vé	kül földii vé
határ őr ség	határ őrsség
kül földi ek	kül föld  ek
megvalósítása_az	meg alósítása_az
föl iratkoz ni	föliiratkoz ni
hat odik	hat od k
mottó	mott
bármerre	bármer e
beteg el lát ás i	betegeelllát ás i
meg vásárol ható	meg vás rol ható
pannónia	pannó  a
motor kerék pár Gár	motor kerék párGGár
por téká ról	portték  ról
közzé te tt	közzéttettt
ős eink	ő  eink
kézilabda Capat unk	kézila da Capat unk
röp labdá s aink	röpllabd ss aink
kajak _ kenu	kajak__ kenu
Gors korCoLá z ó	Gors kor oLázz ó
jel öl és ei	jelööl és ei
kormáN Só vivő	kormáN Só viv
meg ért em	meg ér  em
mti_ nek	mti_nnek
bélá ért	bél  ért
kiráL ság á nak	ki áL ság á nak
totem Serű	totemSSerű
utánGártott	után árt tt
időSerű vé	idő  rű vé
radiátor ig	radiátoriig
leg naGvonalú bb	leg naG onal  bb
tapéta bordűr t	tapét  bordű  t
felülnézet et	felül ézet et
kéS ül het ne	kéSüül het ne
koelreuteria	koelr uteria
belépő	be épő
slavei	slav i
naG apát i	naGaapát i
igaz i ból	igazii ból
CéSé vel	CéS  vel
jóképű	jó ép
aStal om hoz	aStaloom hoz
át ver t e _	át ver tee _
ké ne _	kénne _
mobil om	mobiloom
naranClev et _	naranCleveet _
fonat	fon t
hig Gek	hiG Gek
félre lép és t	félrellép és t
viz et _	vizeet _
ő k et _	őkk et _
daruma	darum
lepké k _	lepkékk _
nevet ő	nev tőő
herNó Sőr ök _	herN  Sőr ök _
ár adat ból _	áraadat ból _
baZaróZá k _	baZa  Zákk _
Somorúfűz	Somorú ű
lov am	lovaam
viSS hang já t _	viSShhang já t _
világ ra _	világrra _
Sen ek _	Seneek _
mögött ünk _	mög tt ünk _
dob ott	doboott
vértesboglár ra	vér es oglár ra
Sabotál ás á ra	Sabot l ás á ra
sebz ett	sebzeett
mező őr	mezőőőr
fejér	fej r
buS parkoló	buSpparkol
drágá m	drágámm
le lő ttem	lellőttt m
férj em é	férj eméé
újjá Sül et és re	újjáSSül et és re
tan foLam aink ról	tan foLam ai k ról
4 4 _ _ is	4 4____iis
hitel kárTá hoz	hitelkkárTá hoz
diSkont	diSkon
sportSerű	sport erű
pár baj kódex	párbbaj jódex
víziló	vízil
böffen t	böff ntt
susan	sus n
megdöbbentő en	meg öbbentő en
hozzá segít	hozzássegít
fiGelemreméltó	fiGelem  méltó
virrad ó	virr d ó
Sed hető	Sed het
tabletta Sed és sel	tablet a Sed és sel
feS es	feSees
SuNNad ó	SuNN d ó
zöldalma	zöldalm
Sár ad ás	Sáraad ás
vasal ás sal	vas l ás sal
v_65_b	v_ 5_b
bele ill enek	bele illeenek
különböz tet ni	különbözttet ni
viSSa hőköl	viSSa hő  l
meg semmisül ök	meg semmi  l ök
adorján i	ador ánii
hoLLwood i	hoLLwoodii
Cattan tak	Cat an tak
igé z ni	igézz ni
désére	dés re
problémá itok at	problémá i ok at
leG etek	le eetek
levél küld és t	le  lkküld és t
illem tan á t	illemttan á t
mailman	mailm n
üG es ked ő k	üG es kedőő k
Sámla vezet ő	Sámla vezetőő
mártír társ ai	mártírttárs ai
harminc adik	harmincaadik
el Senved ő i vel	el Senvedőő i vel
harm ad a _ neGed e	harmaadaa _ neGedee
Salon ok ban	Salonook ban
tranSveS	tran veS
vezér ürü k	vezér ürükk
hibáztat hat tam	hibáz at hat tam
fel vállal om	fel vállaloom
tartoz ol	tartozool
Soltak	Sol  k
diSk rét ek	diSkrréteek
eGen súL t	eGenssúL t
lát nád	látnnád
3 5_ ig	355_ ig
apu kád	apukkád
haza vi dd	haza viddd
elött	el tt
alatt_senkire	alat  senkire
mond ó	mondóó
fa darabká k ból	faddarabká k ból
át leng i	átlleng i
meg vásárl ás á nak	meg vás rl ás á nak
Sembenálló	Sembenáll
villant ani	villan  ani
önbizalom mal	ön izalom mal
durcás	durc
úss z	úS  S
flört öl és t	flörtööl és t
e _ generáció	e__ generáció
e _ demokrácia	e__ddemokrácia
reflektor féN ben	reflektorfféN ben
sms _ segéL	sms__ segéL
vizitúrázás	vizitúráz s
fog ad ó _ órá ban	fogaad ó _ órá ban
vizitúrázást	vizitúrá  st
mentalitás á t	menta itás á t
viSlát	viSlá
vál ás ig	váláás ig
látkép é ből	lát ép é ből
lanká t	lank  t
mű véS ek et	művvéS ek et
lélek Sám á ban	lélekSSám á ban
hit élet é ben	hit él t é ben
mindSent i	mindSentii
araN_ércz_	araN ércz_
ember öl tő	ember ölttő
pillant ás ra	pillan  ás ra
másodperc es	másodpercees
glasenapp	glas napp
ág az ott	ágaaz ott
Sed ve	Sedvve
meg ismertet i	meg ismer  t i
idő Sámít ás	idő Sám t ás
kötet et	köteteet
vál ogat ás t	váloogat ás t
Stár hasáb ja	Stár has b ja
leG es ked és kor	le ees ked és kor
stand méret	standmmér t
válaS lap	válaSllap
Servező	Serv ző
puStamérges	puSta  rges
menekül t ként	menekültt ként
miské re	miskérre
meNhért	meNhér
mórahalm on	móra alm on
nehéz ség ei ről	nehéZ ség ei ről
noémi	noém
régmúlt	régmúl
vál ogat ás unk	váloogat ás unk
mobil telefon os	mobilttelefon os
ki zöld ül	ki zöldüül
kálciumot	kálcium t
magnisállal	magni ál al
táp oldat oz ás sal	tápooldat oz ás sal
Sellő z tet és e	Sellőzz tet és e
vydate	vydat
táp kocká s	táp kock ss
amónium_nitrát	amónium nitrát
félé k	félékk
építéS mérnök	ép téS mérnök
le eGSerű sít ik	le eGSerűssít ik
_ komoL an	_kkomoL an
magán alapítváN	magánaalapítváN
ft _ fő _ hó	ft__ fő _ hó
mulatság a	mulat ág a
1 5 30 _ kor	1 5 00 _ kor
hozzá járul nának	hozzá járul nán k
segít enének	segít ené ek
ér tél	érttél
al cím é ül	alccím é ül
tár sas ház ak	társsas ház ak
tár sas ház	társsas ház
tár sas ház at	társsas ház at
kis öSSeg ű	kisööSSeg ű
lak ás Serz és i	lak áS Serz és i
ad ó mentes ek	ad ó ment s ek
tár sas ház ak ra	társsas ház ak ra
jogosul t tá	jogosulttttá
fél teké től	féltteké től
válaS tó vonal	válaSttó von l
Soció_ökonómiai	Soció ökonóóia
rend el ék ez és re	rendeeléék ez és re
kolera	koler
iv ó víz minőség ű	iv óvvíz m nő  g ű
édes viz et	édes vizeet
víz igéN ek	víziigéN ek
tengervíZótalanitó	tenger íZótalanitó
le rak ód ás ok	le rakóód ás ok
tranS közép	tranS Sözép
iváSat	iváS t
sugdolóz ás	sugdol z ás
öngól	öng l
komoLtalan abb ak	komoL alan abb ak
hasonmás verseN t	hason ásvverseN t
lajhár	laj ár
seb es ség es _	sebees ség es _
elég Ser	elégSSer
felvonó k on	fel onókk on
agorá ban	agor bban
l8_án	l _án
vakolat rend Ser	vakola  rend Ser
cél kereSt ben	célkkereSt ben
vihar ok	vi ar ok
játS at ta	játS attta
le vezekel te	levvezekel te
fel robbant ottad	fel robbant ott d
el üSk ös öd ött	el üSköös öd ött
monditt	mondi t
emlékez ett	emlék zeett
morZol gat od	morZolggat od
oda téved t	odattéved t
kúss zanak	kúS azanak
farkaSemet	far    m t
naGkaniZá n	naGkaniZánn
közép hő mérséklet	középhhő mérséklet
jég eső ről	jég es  ről
kúS ott	kúSoott
